111111111111111
1P00C000E000001
100C1C000000001
100000000000001
111111111111111