1111111111111111111111111
1P00000000000000000000001
1011110111110111111111101
1000010000010000000000001
1011011111011111110111101
1C00000000000100001000001
1011110111110111101111101
1000000000000C00000000001
1011111111110111111111101
1000000000T00000000000001
1011101110111011101110101
1C0000000000C0000000000E1
1011111111111111111111101
1000000000000000000000001
1111111111111111111111111
